Afrikaans: af
Arabic: ar
Bulgarian: bg
Bangla: bn
Bosnian: bs
Catalan: ca
Czech: cs
Welsh: cy
Danish: da
German: de
Greek: el
English: en
Spanish: es
Estonian: et
Persian: fa
Finnish: fi
Filipino: fil
Fijian: fj
French: fr
Hebrew: he
Hindi: hi
Croatian: hr
Haitian Creole: ht
Hungarian: hu
Indonesian: id
Icelandic: is
Italian: it
Japanese: ja
Korean: ko
Lithuanian: lt
Latvian: lv
Malagasy: mg
Malay: ms
Maltese: mt
Hmong Daw: mww
Norwegian: nb
Dutch: nl
Quer√©taro Otomi: otq
Polish: pl
Portuguese: pt
Romanian: ro
Russian: ru
Slovak: sk
Slovenian: sl
Samoan: sm
Serbian (Cyrillic): sr-Cyrl
Serbian (Latin): sr-Latn
Swedish: sv
Kiswahili: sw
Tamil: ta
Telugu: te
Thai: th
Klingon: tlh
Tongan: to
Turkish: tr
Tahitian: ty
Ukrainian: uk
Urdu: ur
Vietnamese: vi
Yucatec Maya: yua
Cantonese (Traditional): yue
Chinese Simplified: zh-Hans
Chinese Traditional: zh-Hant